
appearance - внешность
He made a deep impression - Он произвел глубокое впечатление
Your appearance is pleasant for me - ваша внешность приятна для меня
witty person - остроумный человек
shallow person - поверхностный человек
attract - привлекать
disgust - отвращать
underpants - подштанники
sweater - свитер
He is famous at narrow circles - Он известен у узких кругах
Have you ever dyed your hair? - Вы когда-нибудь красили свои волосы?
Grey hair - седина
I want to get rid of my old clothes - я хочу избавиться от моей старой одежды
She put on a jacket - она надела куртку
tough guy - жесткий парень
cool guy - крутой парень
weak - слабый
workaholic - трудоголик
culture vulture - культурный стервятник
party animal - тусовщик
couch potato - лежебока
charismatic guy - харизматичный парень
he looks juicy - он выглядит аппетитно
neat and tidy - опрятный и чистый
well dressed - хорошо одетый
annoying - раздражающий
first impression - первое впечатление
bow tie - галстук бабочка
official men's suit - официальный мужской костюм
man of age - мужчина в возрасте
experienced man - опытный мужчина
attractive - привлекательный
wavy hair - волнистые волосы
curly hair - кудрявые волосы
straight hair - прямые волосы
he is bald - он лысый
skinny - костлявый
slim - худой
fat - жирный
overweight - избыточный вес
plump - упитанный
lop eared - лопоухий
eyebrows - Брови
upturned - вздернутый
angular - угловатый
pale - бледный
tanned - загорелый
beautiful women - красивая женщина
handsome men - красивый мужчина
she isn't my taste - она не в моем вкусе
I like people with European appearance - мне нравятся люди с европейской внешностью
mature people - зрелые люди
adult people - взрослые люди
experienced people - опытные люди
just for intertainment - просто для развлечения
time wasting - пустая трата времени
no time to waste - не будем терять времени
blessing - благословение
benefitial - выгодный
trades of character - черты характера
externally - внешне
internally - внутренне
generous - щедрый
mean - жадный
exhausted - измученный
appearance - внешность
character - характер
cute - милый
rosy cheeks - розовые щеки
Her hair looks glossy - ее волосы выглядят блестящими
his outfit - его наряд
dressing up - наряжаться
He has strange taste - у него странный вкус
go on a date - сходи на свидание
You could be cheated - ты можешь быть обманут
pleasant - приятный
spark - искра
wrinkled face - морщинистое лицо
She is very forgetful - она очень забывчивая
behaviour - поведение
We started chatting - мы начали болтать
she must not be excited - ей нельзя волноваться
he is punctual - он пунктуален
How was she feeling? - Как она себя чувствовала?
I do my best - я делаю все что в моих силах
Men more confident then women - мужчины более уверенные чем женщины
He's like that by nature - он такой по природе
people's behavior - человеческое поведение
hot-tempered - вспыльчивый
impressive - выразительный
confident - уверенный
patient person - терпеливый человек
You are stubborn as a donkey - ты упрямый как осел
superior person - высшая личность
flexible behavior - гибкое поведение
he wears hat - он носит шляпу
Aries - Овен
Taurus - Телец
Gemini - Близнецы
Cancer - Рак
Leo - Лев
Virgo - Дева
Libra - Весы
Scorpio - Скорпион
Sagittarius - Стрелец
Capricorn - Козерог
Aquarius - Водолей
Pisces - Рыбы
small effort of the will - небольшое усилие воли
he walked with effort - он ходил с трудом
obedient and responsible guy - послушный и отверственный парень
determined - решительный
sensitive - чувствительный
touching - трогательный
hyperbolized - гиперболизированный
unpleasant - неприятный
Act of kindness - акт доброты
charity - благотворительность
SACRIFICE - ЖЕРТВЕННОСТЬ
quality - качество
My life attitude - моя жизненная позиция
NEAT AND TIDY - ОПРЯТНЫЙ И ЧИСТЫЙ
Your outfit - твой наряд
your image - твой образ
TWO EXTREMES - ДВЕ КРАЙНОСТИ
What style is welcome? - какой стиль приветствуется?
generosity - щедрость
kindness - доброта
stubbornness - упрямство
pride - гордость
malice - злоба
shyness - застенчивость
determination - решительность
sensitiveness - чувствительность
soreness - болезненность
tiredness - усталость
miserliness - скупость
annoyance - раздражение
delicacy - деликатность
She is dressed very fashionable - Она одета очень модно
wild hair - растрепанные волосы
His life is exciting - у него захватывающая жизнь
His life is boring - его жизнь скучна
His life is buzy - у него насыщенная жизнь
His life is stressful - его жизнь полна стрессов
His life is lazy - его жизнь это лень
His life is relaxing - его жизнь это отдых
His life is fun - у него веселая жизнь
his routine is UNUSUAL - у него необычный распорядок дня
daily routine - повседневные дела
lazy weekends - ленивые выходные
relaxing evening - расслабляющий вечер
sociable - общительный
communicative - коммуникативный
talkative - разговорчивый
he looks younger then he is - он выглядит моложе чем он есть
wealthy man - состоятельный мужчина
tanned - загорелый
pale - бледный
blond hair - светлые волосы
dark hair - темные волосы
confident - уверенный
unsure - неуверенный
horrible - ужасный 
gorgeous - великолепный
attractive - привлекательный
unattractive - непривлекательный
She is tall and slim - она высокая и стройная
He's an attractive middle aged man - он привлекательный мужчина средних лет
He is short and plump - она невысокая и пухленькая
He is very pleasant - он очень приятный
behavior - поведение
bad temper - дурной характер
rude - грубый
sympathetic - сочувствующий
unsympathetic - черствый
frank - откровенный
greedy - жадный
mean - скупой
proud - гордый
strict - строгий
tolerant - терпимый
gentle - деликатный
lazy - ленивый
reliable - надежный
ambitious - амбициозный
lonely - одинокий
shy - застенчивый 
jealous - ревнивый
selfish - эгоистичный 
sentimental - чувствительный
aggressive - напористый
courageous - смелый
sociable - общительный
adorable - прелестный
grateful - благодарный
thoughtful - чуткий
brave - храбрый
patient - терпеливый
pleasant - приятный
cheerful - веселый
joyful - радостный
supportive - поддерживающий
generous - щедрый
honest - честный
determined - решительный
punctual - пунктуальный
polite - вежливый
imaginative - творческий
stubborn - упрямый
snobbish - снобистский
chatty - болтливый
talkative - разговорчивый
weird - непонятный
strange - странный
unusual - необычный
supernatural - сверхъестественный
otherworldly - потусторонний
mysterious - мистический
fatal - роковой
horrible - жуткий
sinister - зловещий
bizzare - причудливый
fantastic - фантастический
inattentive - невнимательный
attentive - внимательный
dim eyes - тусклые глаза
Confident girl - уверенная девушка
thin body - худое тело
slender body - стройное тело
graceful figure - изящная фигура
weavy hair - волнистые волосы
Serious guy - серьезный парень
cheeky girl - дерзкая девчонка
Cheerful guy - жизнерадостный парень
small curls - маленькие кудряшки
