
resume - резюме
general place - общественное место
brunch - бранч
church ceremony - церковная служба
clergyman - клирик
priest - священник
previous work - предыдущая работа
exchange of experience - обмен опытом
chief manager - управляющий
due to the recomendation - благодаря этой рекомендации
it counts too - это тоже считается
I am unemployed - я безработный
He doesn't want to retire - Он не хочет уходить в отставку
I worked as a waiter - я работал в качестве официанта
I've never worked in an office - я никогда не работал в офисе
work abroad - работать заграницей
bell ringing lesson - урок колокольного звона
The bell Ringer - звонарь
he was sweeping the pavement - он подметал тротуар
I looked up vacancies - я просматривал вакансии
to mount - монтировать
to install - устанавливать
to repair - ремонтировать
IS THERE a microwave? - там есть микроволновка?
I do research - Я навожу справки
to be on call - быть на дежурстве
to solve tasks - решать задачи
master of finishing works - мастер отделочных работ
sales manager - менеджер по продажам
choreographer - хореограф
According to the rules - Согласно правилам
I commute by car - Я езжу на работу на машине
I took some hours off - я взял отгул на несколько часов
I completely satisfied - я полностью удовлетворен
interprener - предприниматель
repair shop - ремонтная мастерская
hardware store - строительный магазин
very productive - очень продуктивно
This week wasn't much eventfull - эта неделя была не слишком насыщена событиями
long awaited meeting - долгожданная встреча
to the majority of us - для большинства из нас
basicly - в основном
members - участники
your worries and impressions - ваши заботы и впечатления
I'm expecting good news - я ожидаю хороших новостей
it was unexpected for me - это было неожиданно для меня
I would like to pay your attention to - я хочу обратить ваше внимание на
I have a very busy job - у меня очень занятая работа
I don't mind - я не против
overtime - сверхурочно
As far as I remember - насколько я помню
Are you ready to work on your own? - вы готовы работать самостоятельно?
pick up some ideas - почерпнуть некоторые идеи
pick out some words from text - выделить несколько слов из текста
He managed to complete this project on time - Он сумел завершить этот проект вовремя
annual bonus - годовой бонус
She predicts future - она предсказывает будущее
Meteorologist predicts weather - метеоролог предсказывает погоду
drop calls - сбрасывать звонки
recieve calls - принимать звонки
transmit information - передавать информацию
search line - поисковая строка
exchange messages - обмениваться сообщениями
urgent call - неотложный звонок
typing - печатать
share on the internet - Выложить в интернет
download - скачать
upload - загрузить
except message - принять сообщение
except agreement - принять соглашение
phone diary - телефонный дневник
work shedule - рабочее расписание расписание
For the majority of people it is working day - для большинства людей это рабочий день
working shift - рабочая смена
It doesn't permit - это не разрешено
permittion - разрешение
staff inside wearing masks - персонал внутри носит маски
I'm at the end of my rope - я на пределе своих возможностей
my rope - моя веревка
struggle begins with words - сражение начинается со слов
Singapore fell without even a struggle - Сингапур был взят даже без боя
power struggle - силовое противостояние
It's all for nothing - все зря
It was all in vain - все было тщетно
I'm grading you on the effort - я ставлю тебе оценку за стремление
I hit him by accident - я ударил его случайно
listen to my demands - слушайте мои требования
government - государство
profession - профессия
organization - организация
signal - сигнал
warning - предупреждение
explanation - объяснение
situation - ситуация
process - процесс
punishment - наказание
encouragement - поощрение
crime - преступление
rewarding - награждение
checking - проверка
separation - разделение
connection - соединение
I skip the obligatory greeting - я пропускаю обязательное приветствие
I've achieved good results - я достиг хороших результатов
wood dust - древесная пыль
installation work - монтажные работы
companion - компаньон
comrade - товарищ
combat comrade - боевой товарищ
collegue - коллега
supporter - сторонник
follower - последователь
We appreciate those efforts - мы ценим эти усилия
meaningful - значимый
rare case - редкий случай
it occurs very often - это случается очень часто
extremely rare occurance - очень редкое явление
fortune teller - гадалка
lorry - грузовик
loan - кредит
without charge - без оплаты
for nothing - даром
faith - вера
good salary - хорошая зарплата
thankfully we can use it - к счастью мы можем этим воспользоваться
compensation - вознаграждение
We were hired by the family - Мы были наняты семьей
We are hiring women - Мы нанимаем женщин
Make your contribution more valuable - Сделайте свой вклад более значимым
It's peer pressure - это давление со стороны коллег
smoke screen - дымовая завеса
smoke detector - детектор дыма

