
mayonnaise - майонез
oil - масло
sour creme - сметана
soy souce - соевый соус
vinegar - уксус
greens - зелень
cookies - домашнее печенье
biscuits - покупное печенье
What food did you have? - Какую еду вы ели?
I want to yamn - Мне хочется зевнуть
I've had a supper - Я поужинал
I don't know the recipe - я не знаю рецепта
I USED TO visit this place before - раньше я посещал это место
can of Coke - банка с колой
tin of tuna - банка с тунцом
carton of cigarettes - блок сигарет
give me to cartons - дай мне две пачки
he drinks out of the carton - он пьет прямо из пакета
a little cereal for breakfast - немного хлопьев на завтрак
They haven't asked for the bill - Они не просили счёт
takeaway - еда на вынос
foody - гурман
volume of the drink - размер напитка
milk foam - молочная пенка
What is a volume of your cup - Каков объем вашей чашки?
tea with flavours - чай со вкусами
cereal - овсянка
Your stomach is empty - твой желудок пуст
remarkable drink - замечательный напиток
exclusive recipe - эксклюзивный рецепт
main dish - основное блюдо
roast chicken - запеченая курица
baked cookies - испеченное печенье
fried meat - жареное мясо
grilled fish - рыба на гриле
prune - чернослив
trout - форель
salmon - лосось
fresh celery - свежий сельдерей
