
He was tuning a guitar - он настраивал гитару*
Vacuum cleaner was fixed - пылесос был починен**
I like to walk a dog - Мне нравится выгуливать собаку
Petting the cat - гладить кота
They often bark at me - Они часто лают на меня*
Are there any books on the shelf? - На полке есть книги?**
Are there any glasses in the cupboard? - В кухонном шкафу есть стаканы?
Is there a fireplace in the living room? - в жилой комнате есть камин?
tidy the room - убирать комнату
hang the coat on the hook - повесь пальто на крючок
bathroom equipment - сантехника*
plumbing - водопровод*
keys are in my backpack - ключи в моем рюкзаке
iron - утюг
tissue - ткань
notebook - блокнот
purse - кошелек
wallet - бумажник*
ceiling - потолок
cooker - плита
oven - духовка*
I love taking a shower - я люблю принимать душ
I have a shelf above my desc - у меня полка над столом
wardrobe - шкаф
CENTRAL HEATING - центральное отопление
I would sell a flat - я бы продал квартиру
to have a nap - вздремнуть
Did you repair your washing machine? - ты починил свою стиральную машину?
from top to bottom - сверху донизу
DIY approach - подход сделай сам
I do my hobbies instead of sleeping - я занимаюсь своими хобби вместо того чтобы спать
sewing - шитье
knitting - вязание
recieve gifts and congradulations - получать подарки и поздравления*
blowing out candles - задувать свечи*
Blow out the candles and make a wish - задуй свечи и загадай желание*
candle - свеча
candlestick - подсвечник
Opportunity to make a wish - возможность загадать желание*
Do your dreams come true? - сбываются ли ваши мечты?
Do you make wishes? - вы загадываете желания?**
chandelier - люстра
ceiling - потолок
piece of furniture - предмет мебели*
piece of clothing - предмет одежды**
The day passed unnoticed - этот день прошел незаметно*
Have you already put up a Christmas tree? - Вы уже поставили елку?
is it natural tree? - Это натуральное дерево?
is it artificial stone? - Это искусственный камень?*
Is it sand in a bucket? - Это песок в ведре?*
coziness - уют
cozy armchair - уютное кресло
exchange gifts - обмениваться подарками
Are your curtains patterned? - Твои шторы узорчатые?
My curtains are plain - Мои шторы простые
partly - частично
plain - простой
patterned - узорчатый
storage wardrobe - шкаф для хранения
cart - тележка
fir tree - ель*
toy angel - игрушечный ангел**
What are your preferences? - Какие у тебя предпочтения?
postcards - открытки*
magazine issue - номер журнала
sparrow - воробей
warm nest - теплое гнездышко
host family - принимающая семья
disgusting sound - отвратительный звук
jar - кувшин
I poured myself a drink - я налил себе выпить
Pour the oil - Лейте масло
dim light - тусклый свет
gloomy room - мрачная комната
brindled curtains - пестрые занавески
He doesn't bite - он не кусается
fishing rod - рыболовная удочка
sauna - сауна
among your friends - среди твоих друзей
The clock chimed twelve - часы пробили двенадцать
Did your wishes come true? - исполнились ли ваши желания?
bright accessories in green colour - яркие аксессуары зеленого цвета
I attached pictures - я приложил фотографии
topic of the discussion - тема обсуждения
I greeted you - я поприветствовал вас
bad mood - плохое настроение
each member of the family - каждый член семьи
children are opening presents - дети открывают подарки
elderly people are sitting at the table - пожилые люди сидят за столом
It's cozy here - здесь уютно
Dog is standing near his owner - собака стоит рядом со своим хозяином
Toys are hanging from the ceiling - игрушки свисают с потолка
two deer - два оленя
artificial wreath - искуственный венок
we won't waste time - мы не будем терять время
Are you with us? - Ты с нами?
share your knowledge - поделитесь своими знаниями

