
particular place - особенное место
He accepted her offer - Он принял ее предложение
Don't be regret about it - Не сожалей об этом
That ruined my mood - Это испортило мне настроение
They have argued - Они поссорились
This is ridiculous - Это просто смешно
He is my old pen pal - Он мой старый друг по переписке
Am I talking loud - я громко разговариваю?
She was going to text a friend - Она собиралась написать другу
He mentioned his sister - Он упомянул свою сестру
We discussed important questions - Мы обсудили важные вопросы
They're very productive - Они очень продуктивны
He has a bad habit - У него плохая привычка
widely known information - широко известная информация
It depends on my mood - Это зависит от моего настроения
remind me where are you now - напомни мне где ты сейчас
We took a loan - мы взяли ипотеку
She has good habits - у нее хорошие привычки
I'm in love with HER - я в нее влюблен
Do you know those people? - Ты знаешь этих людей?
Who did you go with? - С кем ты пошел?
She wants to live independently - она хочет жить независимо
to win an argument - выиграть спор
WHO DO you live with? - с кем ты живешь?
He is afraid - он боится
Little kids are afraid of the dark - маленькие дети боятся темноты
Honestly - честно говоря
divinity emotions - божественные эмоции
The Ugly Duckling - Гадкий Утёнок
She dislikes pets - ей не нравятся домашние животные
I am aschamed - мне стыдно
He is crazy about her - он сходит с ума по ней
She has a crush on him - она втюрилась в него
We felt affection to each other - мы чувствовали привязанность друг к другу
Losing makes me mad - проигрыш сводит меня с ума
She was annoyed with her husband - она была раздражена своим мужем
Losing her dog made her sad - потеря собаки опечалила ее
I'm feeling down today - сегодня я чувствую себя подавленным
sense of joy - чувство радости
she was frightened - она была напугана
OK then - тогда ладно
Talk to you later - Поговорим позднее
so called - так называемый
at last - наконецто
Lucky you! - Счастливик!
Poor you! - Бедняга!
one of her highlights - одна из ее изюминок
I have to go - Мне нужно идти
Have fun! - Веселитесь!
enjoy your life - наслаждайся своей жизнью
What's wrong? - что не так?
No way - Ни за что
put on make up - делать макияж
I find it boring - я нахожу это скучным
I find it wise - я нахожу это мудрым
I find it difficult to explain myself - я нахожу трудным объясниться
I find it delicious - я нахожу это восхитительным
I am happy - Мне весело
I am sad - Мне грустно
I am bored - Мне скучно
I am pleased - Мне приятно
I am good - Мне хорошо
I am interested - Мне интересно
relatives - родственники
distant relatives - дальние родственники
close relatives - близкие родственники
I used to have many familiars - Раньше у меня было много знакомых
I used to have a wife - Раньше у меня была жена
I would start a family - я бы завел семью
I would have to say it - Мне пришлось бы сказать это
I'm a little bit jealous - Я немного завидую
What a pity - Какая жалость
I haven't asked you for pity - Я не просил о сочувствии
I didn't envy her - Я не завидовал ей
seems to me - Мне кажется
no doubt - Нет сомнений
gloomy period of life - мрачный период жизни
saving for a rainy day - откладывать на черный день
Let me focus on my day - Позвольте мне сфокусироваться на своем дне
Let me think - Дайте мне подумать
Let me guess - дайте угадаю
Why did he let me off - Почему он меня отпустил?
It's another occasion - это другой случай
I'm shy - Я стесняюсь
Oncoming message - входящее сообщение
unfortunately - к несчастью
fortunately - к счастью
frankly speaking - откровенно говоря
Do you approve strict teachers? - Ты одобряешь строгих учителей?
Your evironment helps you - твое окружение помогает тебе
he obeys me - он подчиняется мне
stay on your ground - стоять на своем
he always stays on his ground - Он всегда стоит на своем
under the custody - под опекой
under protection - под защитой
Could you please remind me? - Вы не могли бы мне напомнить?
She said it intentionally - она сказала это намеренно
I've lost my patience - я потерял свое терпение
I'm losing my patience - я теряю терпение
enough is enough - достаточно значит достаточно
this is your last chance - это твой последний шанс
My patience is wearing thin - мое терпение истощается
I was fed up - я был сыт по горло
She refused all my efforts - она отвергала все мои попытки
exaggerate story - преувеличенная история
They received a good upbringing - они получили хорошее воспитание
he was born into poverty - он родился в нищете
feeling - чувство
emotion - эмоция
idea - идея
thought - мысль
position - позиция
offspring - отпрыск
sooner or later - рано или поздно
It's a great temptation for me - это большое искушение для меня
beforehand - заранее
I like do everything beforehand - Мне нравится делать все заранее
I can't date my dad - я не могу встречаться со своим отцом
how to look after a woman? - как ухаживать за женщиной?
spark - искра
He has had several dates - У него было несколько свиданий
I don't mind - я не возражаю
They were right for him - они были как раз для него
women respect men for their power - Женщины уважают мужчин за их силу
fear to lose - страх потерять
imperious - властный
men qualities - мужские качества
I appreciate it - я ценю это
he likes to make jokes - он любит шутить
requirements for his future wife - требования к его будущей жене
fearfully to be married - страшно быть женатым
flipping - перелистывание
swithing - переключение
click next - нажимать далее
We get on well - Мы хорошо ладим
I don't want to upset anyone - я нехочу никого расстраивать
coincidence - совпадение
she has been tearful - она была вся в слезах
being apart - быть в разлуке
all you need is cunning and audacity - все что тебе нужно это хитрость и дерзость
curious situation - любопытная ситуация
sorrow - огорчение
I cried in delight - я закричал в восторге
delight - восторг
I was disappointed - я был разочарован
I do believe in her - я действительно верю в нее
I expect that - я ожидал этого
shape of my heart - форма моего сердца
I'm not superstitious - я не суеверный
touching novel - трогательная новелла
heartbreaking story - душераздирающая история
dinner was nearly ready - ужин был почти готов
she was afraid - она была напугана
don't you love me any more? - разве ты больше не любишь меня?
he looked round the room - он оглядел комнату
Shall I get the dinner? - Может мне принести ужин?
she pulled off the paper - она развернула бумагу
she held it out to him - она протянула это ему
he put his hands behind his head - он заложил руки за голову
You see I sold them - видишь ли я их продал
I'm confused with this behaviour - я смущен этим поведением
I'm confused with your question - я смущен вашим вопросом
I worried about it - я беспокоился об этом
once and forever - раз и навсегда
very good deed - очень хороший поступок
touching deed - трогательный поступок
self sacrifice - самопожертвование
husband sacrificed his watch - муж пожертвовал своими наручными часами
