
department store - универмаг
chancellery - канцелярия
delivery man - курьер
We've been in the shop - Мы были в магазине
We've gone shopping - Мы ходили в магазин
They are BLUE jeans - это синие джинсы
Whose bag is this? - чья это сумка?
quite expensive - достаточно дорогой
jacket - куртка
jeans - джинсы
shirt - рубашка
Tshirt - футболка
a skirt / юбка
shoes - обувь
sweater - свитер
trousers - брюки
Where are my clothes? - Где моя одежда?
smelly clothes - вонючая одежда
go to the clothes - переходим к одежде
Where can I try it on? - где я могу это примерить?
to change - переодеваться
fitting room - примерочная
changing room - раздевалка
dressing room - гардеробная
shop assistant - продавец консультант
customer - покупатель
purchase - покупка
hoody - толстовка с капюшоном
hood - капюшон
Puffer jacket - пуховик
denim jackets - джинсовая куртка
Trendy skirt - трендовая юбка
sports bra - спортивный бюстгалтер
outerwear - верхняя одежда
fashionable - модный
elegant - элегантный
wide belt - широкий ремень
cell phone - мобильный телефон
gadget - устройство
device - устройство
make of phone - марка телефона
On sale for 5000 - продается за 5000
I'll pay in cash - я оплачу наличными
Could you help me - вы не могли бы помочь мне?
few apples - несколько яблок
little time - немного времени
how to spend money? - как тратить деньги?
pullover - пуловер
tights - колготки
boots - сапоги
gloves - перчатки
hat - шапка
scarf - шарф
lack of money - нехватка денег
shop window - витрина магазина
shopping list - список покупок
reasonable people - разумные люди
we buy only necessary things - мы покупаем только необходимые вещи
shopaholic - шопоголик
I'm for - я за
I'm against - я против
from top to bottom - сверху донизу
souvenirs - сувениры
accessories - аксессуары
necklace - ожерелье
earrings - сережки
charming dress - очаровательное платье
striped blouse - полосатая блузка
checkered shirt - клетчатая рубашка
pastel colored suit - костюм пастельных тонов
low heeled shoes - туфли на низком каблуке
high heeled shoes - туфли на низком каблуке
heel - каблук
tissue belt - тканевый пояс
wide trousers - широкие брюки
cute shop - милый магазинчик
gold chain - золотая цепочка