
explore the city - исследовать этот город
observation wheel - колесо обозрения
main sight - главная достопримечательность
This is the main sight of Volgograd - Это главная достопримечательность волгограда
I chose wrong direction - я выбрал неправильный путь
within Moscow - в пределах Москвы
I get to work by train - я добираюсь до работы на поезде
I get to work by tram - я добираюсь до работы на трамвае
I get to work by trolleybus - я добираюсь до работы на троллейбусе
across the road - через дорогу
through the tunnel - через тоннель
in two days - через 2 дня
in two hours - через 2 часа
experienced traveller - опытный путешественник
I was searching for a map - я ищу карту
Are you Brazilian? - Ты бразилец?
Is he Turkish? - Он турок?
We got home late - мы добрались до дома поздно
to book - бронировать
Here we are - Вот мы и здесь
charge a fee - взимать плату
above the ground - над землей
It's open all year round - открыто круглогодично
foggy weather - туманная погода
it's wet outside - на улице сыро
it's raining - идет дождь
it's sunny - солнечно
it's snowing - идет снег
I would like to visit Epypt - я бы хотел посетить египет
I would like to speak English fluently - я бы хотел разговаривать на английском бегло
I like drizzle rain - я люблю моросящий дождь
I got stuck in a traffic jam - я застрял в пробке
they were snowed in - их занесло снегом
he was wet through - он промок насквозь
change it when it get soaked - смени это когда оно намокнет
I like distant places - Мне нравятся отдаленные места
I prefer locations close to my house - Я предпочитаю места близкие к моему дому
gestures - жесты
they used gestures - они использовали жесты
benefit - выгода
natives - аборигены
it was challenging - это было непросто
challenge - вызов
What is the weather in Moscow? - Какая погода в Москве?
unforgettable ten days - незабываемые десять дней
insects - насекомые
schrimp - креветка
family is sacred - семья это святое
scuba diving - подводное плавание
Did you feed elephants? - Ты кормил слонов?
all gaps are filled - все пункты выполнены
My expectations - мои ожидания
Skating rings - катки
at every corner - на каждом углу
enjoy - наслаждаться
resort - курорт
surrounding landscape - окружающий пейзаж
law of nature - закон природы
fact of nature - явление природы
helping hand - рука помощи
occasion - случай
It's pouring outside - На улицу льет как из ведра
wonderful weather - чудесная погода
extraordinary place - необыкновенное место
You're standing on my foot - ты стоишь на моей стопе
I need to find a cash machine - мне нужно найти банкомат
the sun rose slowly among the hills - солнце медленно взошло между холмами
bonfire - костер
country habit - сельский обычай
boats were rusty - лодки были ржавыми
I have a passion for snowboarding - У меня есть страсть к катанию на сноуборде
